 XXXXXXXXX XXXXXXXX
 X XXXXXXXXX X XXXX
   XXXXXXX XXX XXXX
XX  XXXX    XX XXXX
XXX XX X XX        
XXX    X XXXXX XXXX
XXXXXX   XXXXX     
XXXXXX XXXXXXX X D 